1111111111111111111111111111
1111111110011110001111111111
1111111110011111111011111111
1110000110011111111111001111
1111111111111111111101111111
1111011111111110000011111111
1111111111111111111011111111
1111000000000111111011111111
2221111111110110101011000111
2221111111110111111111111111
1111111000000111111111110111
1111111111111111111111111111
1111111111111111111000000111
1111111110000000001111111111
1111111111111111111111111111
1111111111111111101111111111
1111111111111111111100001111
1111111110000000011111110001
1111111111111111111111111111