111111111111111111111111111111
111111111111111011101111111111
110001111011110010000011111101
111100000111000111110010000111
111111111011111111111000110001
101111100111111010111100000111
111101110010011100011111110101
101011101101011001001111110111
111111100011111100010111100001
111111100111111010100011111111
110001001111010101101011111111
111111100011010010111111100001
111111111011111100111111110111
100111111011111010110100000101
110000011101110100111010010111
101111111000111100111111000011
101111111001110010111111110111
111101110011110000010110101010
101100111011101111100111101111
101111101111110011010111101101
101111111001110010111110011101
111001100111111000111110101111
100101111010111101011010101100
111111100111111111011011010001
111111101111111111011010111101
104211101110000101011101101000
102210011111111111111111100000
112210101111111111111111110111
