1111111111000011111111
1111111111111111000001
1111111111111111000001
0011000000000011000111
0011000000000011000111
0011111111111111000111
0011111111111111000111
0011111000111111000111
0011111000111111111111
1111111111111111111111
1122111111111111000111
0022000000000011111111
0022000000000011111111
