1111111111000011000111
1111111111111111000111
1111111111111111000111
0011000000000111000111
0011000000000111000111
0011111100111111000111
0011111100111111000111
0011111000111111000111
0011111000111111000111
1111111011111111000111
1122111011111111000111
0022000000000011111111
0022000000000011111111
