1111111111000111111111
1111111111111111000001
1111111111111111000001
0011000000000011000111
0011000000000011000111
0011111101111100000111
0011111101111110000111
0011111000111110110111
0011111000000000110111
1111111111111111110111
1122111111111111110111
0022000000000001111111
0022000000000001111111
