1111111111001111111111
1111111111111111111111
1111111111111111100111
0001000000110000000111
0001000000111000000111
0011111111111111000111
0011111111111111000111
0011111000000000000111
0011111000111111110111
1111111000111111110111
1111111000111110001111
2221111000111111111111
2221111000111111111111
