1111111111000031111111
1111111111111111000001
1111111111111111000001
0011000000000011000111
0011000000000011000111
0011111111111111000111
0031111111111111000111
0011111000111111000111
0011111000111111111111
1111111111111111111111
1111111111111110001111
2221000000000111311111
2221000000000011111111
