111111111131111111111131111111
111111311111111011111111113111
110001111011110011000011111101
111100000111000111110010000111
113111111011111131111000110001
101111100131131010111100000111
111101110010011100011111110101
101011101101011001001111110111
111111100011111100010111100001
311111100113111010100011111111
110001001111010101101011113111
111111100011010010111111100001
111111111011111100113111110111
100111111011311010110100000101
110000011101110100111010010111
101111111000111100111111000011
101111111001110010111311110111
111101110011110000010110101010
101100111011101111100111101111
101111101113110011010111101301
101111111001110010111110011101
111001100111111000111110103111
100101111010111101011010101100
111111100111131111011011010001
113111101311111111011010111101
102211101110000101011101101000
102210011111111111131111100000
112210101111131111111311110113
