311111111000011
111111111111113
111111111111111
031000000000011
011000000000011
011111111111111
011311111111311
011111131111111
011111111111111
031000000000111
011000000000111
111111111111111
122111113111111
022000000000013
022000000000011
